{
  "meta": {
    "chromaticNumber": 4,
    "cliqueNumber": 4,
    "totalFeatures": 291,
    "atlasColorsUsed": 4,
    "generatedAt": "2026-04-26T20:08:16.384Z"
  },
  "colorAssignment": {
    "ABW": 0,
    "AFG": 0,
    "AGO": 3,
    "AIA": 0,
    "ALB": 1,
    "ALD": 0,
    "AND": 2,
    "ARE": 2,
    "ARG": 2,
    "ARM": 3,
    "ASM": 0,
    "ATC": 0,
    "ATF": 0,
    "ATG": 0,
    "AUS": 0,
    "AUT": 1,
    "AZE": 2,
    "BDI": 2,
    "BEL": 2,
    "BEN": 2,
    "BFA": 0,
    "BGD": 1,
    "BGR": 2,
    "BHR": 0,
    "BHS": 0,
    "BIH": 3,
    "BLM": 0,
    "BLR": 2,
    "BLZ": 2,
    "BMU": 0,
    "BOL": 1,
    "BRA": 0,
    "BRB": 0,
    "BRN": 1,
    "BTN": 2,
    "BWA": 1,
    "CAF": 2,
    "CAN": 1,
    "CHE": 2,
    "CHL": 0,
    "CHN": 1,
    "CIV": 1,
    "CMR": 1,
    "COD": 1,
    "COG": 0,
    "COK": 0,
    "COL": 1,
    "COM": 0,
    "CPV": 0,
    "CRI": 1,
    "CUB": 0,
    "CUW": 0,
    "CYM": 0,
    "CYN": 0,
    "CYP": 1,
    "CZE": 2,
    "DEU": 0,
    "DJI": 1,
    "DMA": 0,
    "DNK": 1,
    "DOM": 0,
    "DZA": 0,
    "ECU": 0,
    "EGY": 0,
    "ERI": 0,
    "ESP": 0,
    "EST": 2,
    "ETH": 2,
    "FIN": 1,
    "FJI": 0,
    "FLK": 0,
    "FRA": 1,
    "FRO": 0,
    "FSM": 0,
    "GAB": 2,
    "GBR": 0,
    "GEO": 1,
    "GGY": 0,
    "GHA": 2,
    "GIN": 0,
    "GMB": 0,
    "GNB": 2,
    "GNQ": 0,
    "GRC": 3,
    "GRD": 0,
    "GRL": 0,
    "GTM": 0,
    "GUM": 0,
    "GUY": 1,
    "HKG": 0,
    "HMD": 0,
    "HND": 1,
    "HRV": 0,
    "HTI": 1,
    "HUN": 2,
    "IDN": 1,
    "IMN": 0,
    "IND": 0,
    "IOA": 0,
    "IOT": 0,
    "IRL": 1,
    "IRN": 1,
    "IRQ": 2,
    "ISL": 0,
    "ISR": 2,
    "ITA": 0,
    "JAM": 0,
    "JEY": 0,
    "JOR": 0,
    "JPN": 0,
    "KAS": 3,
    "KAZ": 2,
    "KEN": 1,
    "KGZ": 0,
    "KHM": 2,
    "KIR": 0,
    "KNA": 0,
    "KOR": 0,
    "KOS": 3,
    "KWT": 0,
    "LAO": 0,
    "LBN": 0,
    "LBR": 2,
    "LBY": 2,
    "LCA": 0,
    "LIE": 0,
    "LKA": 0,
    "LSO": 0,
    "LTU": 3,
    "LUX": 3,
    "LVA": 1,
    "MAC": 0,
    "MAF": 0,
    "MAR": 2,
    "MCO": 0,
    "MDA": 1,
    "MDG": 0,
    "MDV": 0,
    "MEX": 1,
    "MHL": 0,
    "MKD": 0,
    "MLI": 2,
    "MLT": 0,
    "MMR": 2,
    "MNE": 2,
    "MNG": 2,
    "MNP": 0,
    "MOZ": 1,
    "MRT": 3,
    "MSR": 0,
    "MUS": 0,
    "MWI": 3,
    "MYS": 0,
    "NAM": 0,
    "NCL": 0,
    "NER": 1,
    "NFK": 0,
    "NGA": 3,
    "NIC": 0,
    "NIU": 0,
    "NLD": 1,
    "NOR": 2,
    "NPL": 2,
    "NRU": 0,
    "NZL": 0,
    "OMN": 0,
    "PAK": 2,
    "PAN": 0,
    "PCN": 0,
    "PER": 2,
    "PHL": 0,
    "PLW": 0,
    "PNG": 0,
    "POL": 1,
    "PRI": 0,
    "PRK": 2,
    "PRT": 1,
    "PRY": 3,
    "PSX": 1,
    "PYF": 0,
    "QAT": 0,
    "ROU": 0,
    "RUS": 0,
    "RWA": 3,
    "SAH": 1,
    "SAU": 1,
    "SDN": 1,
    "SDS": 0,
    "SEN": 1,
    "SGP": 0,
    "SGS": 0,
    "SHN": 0,
    "SLB": 0,
    "SLE": 1,
    "SLV": 2,
    "SMR": 1,
    "SOL": 0,
    "SOM": 3,
    "SPM": 0,
    "SRB": 1,
    "STP": 0,
    "SUR": 2,
    "SVK": 0,
    "SVN": 3,
    "SWE": 0,
    "SWZ": 0,
    "SXM": 1,
    "SYC": 0,
    "SYR": 1,
    "TCA": 0,
    "TCD": 0,
    "TGO": 1,
    "THA": 1,
    "TJK": 2,
    "TKM": 3,
    "TLS": 0,
    "TON": 0,
    "TTO": 0,
    "TUN": 1,
    "TUR": 0,
    "TWN": 0,
    "TZA": 0,
    "UGA": 2,
    "UKR": 3,
    "URY": 1,
    "USA": 0,
    "UZB": 1,
    "VAT": 0,
    "VCT": 0,
    "VEN": 2,
    "VGB": 0,
    "VIR": 0,
    "VNM": 3,
    "VUT": 0,
    "WLF": 0,
    "WSM": 0,
    "YEM": 2,
    "ZAF": 2,
    "ZMB": 2,
    "ZWE": 0,
    "US_AK": 1,
    "US_AL": 2,
    "US_AR": 2,
    "US_AZ": 3,
    "US_CA": 1,
    "US_CO": 1,
    "US_CT": 3,
    "US_DC": 0,
    "US_DE": 3,
    "US_FL": 3,
    "US_GA": 1,
    "US_HI": 1,
    "US_IA": 2,
    "US_ID": 1,
    "US_IL": 0,
    "US_IN": 1,
    "US_KS": 2,
    "US_KY": 2,
    "US_LA": 3,
    "US_MA": 1,
    "US_MD": 2,
    "US_ME": 1,
    "US_MI": 2,
    "US_MN": 0,
    "US_MO": 1,
    "US_MS": 1,
    "US_MT": 0,
    "US_NC": 2,
    "US_ND": 2,
    "US_NE": 0,
    "US_NH": 2,
    "US_NJ": 3,
    "US_NM": 2,
    "US_NV": 2,
    "US_NY": 2,
    "US_OH": 0,
    "US_OK": 0,
    "US_OR": 3,
    "US_PA": 1,
    "US_RI": 2,
    "US_SC": 3,
    "US_SD": 1,
    "US_TN": 0,
    "US_TX": 1,
    "US_UT": 0,
    "US_VA": 1,
    "US_VT": 0,
    "US_WA": 2,
    "US_WI": 1,
    "US_WV": 3,
    "US_WY": 2
  }
}
